1111111111111
10010000000C1
10P0011111001
10001100000E1
1111111111111