11111111111111111111111111111111111
10010000000011001000000001100100001
100001111100110P0011111001100001111
100000000000000ECCCC000000000000001
11111111111111111111111111111111111