1111111111111
10010000000C1
10P0011111001
1000110000001
1111111111111