1111111111
 100000001
1000000001
1ECP000001
1111111111
