1111111111
1000000001
1000000001
1ECP000001
111111111
