1111111111111
100100E0000C1
10P0011111001
1000110000001
1111111111111