11111111
10000101
10P000C1
100000E1
11111111
