111111
100001
100111
1E1111
100111
1CP001
111111